1111111111111
10C0000000001
110C000011011
1CC100E001011
1CP1000001011
1111111111111