1111111111111
1CCC0CCC00CC1
11EC111011011
1CC1C00C01C11
1CP1C00C01011
1111111111111