11111111
1C0011C1
1PC00101
11111111