1111111111111111111111
1C100C10111011101000C1
101010111C111111101011
1000000P00000000001111
10111010101110101110111
101C11101C101C10001011
1000111011111010111C11
1C10101011111110101011
1110111010001010111011
1C00C00C10101C000000E1
1111111111111111111111