1111111111111
1C00000C00CC1
1100111011011
1CP1C00C01C11
1C01C00C01E11
1111111111111
