1111111111111
11C0000000001
110C000011011
1C1100E001011
11P1000001011
1111111111111