11111111
1C001111
1PE00001
11111111