1111111111111
1E11C0C000001
1010011001C11
10001C00C0101
1111111111110