1111111111111
1C00P00C00CC1
1100111011011
1C01C00C01E11
1111111111111