1111111111111
10000000CC001
1000000CC0111
1001C00C01011
1111111111111