1111111111111
1E11C0C000001
11010011001C1
1001C00C01011
1111111111111