1111111111111
11E1C0C000001
11010001001C1
1001C00C01011
1111111111111